11111111111111111111111111111111111111111111111111
10000000000000000000000000000000000000000000000001
10011111111111111111101111101111111111111111111111
11111111111111111111101111101111111111111111111111
10000001111111110110101111101111111111111111111111
10111111111111101101101111101111111111111111111111
10111111000000000000100000001111111111111111111111
10111111111110110111111111111111111111111111111111
10111111111101101111111111111111111111111111111111
10111111000000000000111111111111111111111111111111
10111111110110111111111111111111111111111111111111
10000001101101111111111111111111111111111111111111
11111111111111111111111111111111111111111111111111
11111111111111111111111111111111111111111111111111