11111111111111111111111111111111111111111111111111
10000001110000111001111111111100011110009111000111
10101011100110001011111111111101011110111110010111
10000001110011100011111111111101011100110000110111
10101101111011110111111110000001011101100101110111
10110100000000110000000000111101011100001101110111
10000001110101110111111110111101011111111111110111
11101101110100000011111000000000000000000000000011
10000011110110111111111011111101111111111101111111
10111110000110111111111011000001111100010000000111
10000000111110001000000011110111100001000111111111
10111111111111100011111000000001110111011111111111
10000000000000001111111011111111110111000011111111
11111111111111111111111111111111111111111111111111