11111111111111111111
10000000000000000001
11111111111111111111
11111111111111111111
11111111111111111111
11111111111111111111
11111111111111111111
10000001111111110110
10111111111111101101
10111111000000000000
10111111111110110111
10111111111101101111
10111111000000000000
10111111110110111111
10000001101101111111
11111111111111111111
11111111111111111111
11111111111111111111
11111111111111111111
11111111111111111111