11111111111111111111111111111111111111111111111111
10000100001111000001111111000111110000001111111111
10110001100010011011010111010111110111011111111111
10111011111000111000000111010000000011011111111111
10000011101011100011011111011110111011011111111111
10101100001111001111000100001110111011011111111111
10100001011111011111010101100000001000011111111111
10111111010000000000010101110101101011011111111111
11101000000110111110110000000101101011011111111111
11100011011110011110000101011101100011011111111111
11101011011111000000101101000001101000011111111111
11111000000000011101100001111100001111111111111111
11111011111111110001111911111111111111111111111111
11111111111111111111111111111111111111111111111111