11111111111111111111111111111111111111111111111111
10100000000000000000000000000000000000000000000001
10111011111111111111101111101111111111110111111111
10000000011111111101101111101111111111110111111111
10111011000000001101101111100000000000000111111111
10001011111111100001101111101111110111110111111111
11100011111111111100000000000011100001110111111111
10101011111111111101111101111011111100000111111111
10000000000000001111111101111011000101110111111111
10111111111111101111111101111011010101110111111111
10000000111000000000000001111011010101110111111111
11111110111011111101111111100000010000000000111111
10000000000000000001111111901111111111111111111111
11111111111111111111111111111111111111111111111111